35
WWWWWWWWWWWWWWWWWW
W                W
W      K    P    W
W    WWWW WWWW   W
W    WssW WssW   W
W    WssW WssW   W
W    WssW WssW   W
W    WssW WssW   W
W    WWWW WWWW   W
W                W
W                W
WWWWWWWWWDWWWWWWWW