60
WWWWWWWWWWWWWWWWWW
WPWTWsWs      B  W
WsssssWsK B B B  W
WWW WsWsWWWWWWW  W
WkWEWsWsW        W
WsW WsWsW  sWWWWWW
W W WsWsW      T W
W W WsWsWWWW WWTWW
W W WsWssssW  WdWW
W W WsWWWWsW  W  W
W   WssssssW sM  W
WWWWWWWWWWWWWDWWWW