75
WWWWWWWWWWWWWWWWWW
WP          W  K W
W  T        W SS W
WWWWssssssssW K  W
WWWWSSSSSSSSS WW W
W       T   W    W
WssssTssssssW  K W
WsKsssssssssWWWW W
WWWWSSSSsSSSWSSW W
WWWWSSSSsSSSWWWW W
WWWWWSSWSSs      W
WWWWWWWWWWWWWWWWDW