WWWWWWWWWWWWWWWWWW
W                W
W    T K    P    W
W    WWWW WWWW   W
W    WssW WssW   W
W    WssW WssW   W
W    WssW WssW   W
W    WssW WssW   W
W    WWWW WWWW   W
W                W
W  K             W
WWWWWWWWWDWWWWWWWW