60
WWWWWWWWWWWWWWWWWW
WWWWWWWWWWWWWWWWWW
WW  Tssssss     WW
WWWdWWsssss B   WW
WW  sssssss B K WW
WW  WWsssssBWWW WW
WW  WWWWSSWWW   WW
WW  WW    W     WW
WW  WW          WW
WWP WW  D WM   kWW
WWWWWWWWWWWWWWWWWW
WWWWWWWWWWWWWWWWWW