60
WWWWWWWWWWWWWWWWWW
W  WWW WWWWW WWWTW
W  TS  TSTS  TS sW
W  sS  sSsS  sS  W
WP WWW WWWWW WWWSW
WWWWWWWWWWWWWWWW W
W              K W
W       K sWWWWW W
WWWWW WWWW   WT  W
WESEW WSTT   Ss  W
WSMSW KSWs   Ss  W
WWWWWDWWWWWWWWWWWW