40
WWWWWWWWWWWWWWWWWW
W                W
W P              W
W  WsssBssssssW  W
W  WssssssssssW  W
W  WssssssssssW  W
W  W K        W  W
WWWWWWWWWW WWDWWWW
WSSSSSSSSWWWSSSSSW
WSSSSSSSSSSSSSSSSW
WSSSSSSSSSSSSSSSSW
WWWWWWWWWWWWWWWWWW