WWWWWWWWWWWWWWWWWW
WsssssssB S d    W
WsWWWWWWW S WWWWDW
WsW     W S W    W
WsW     W S W kW W
WsW   P W S WWWW W
Ws      W S      W
WsW     W S WWWWWW
WsW     W S W    W
WsWWWWWWW S WWWW W
WssssssssES      W
WWWWWWWWWWWWWWWWWW