WWWWWWWWWWWWWWWWWW
W              sKW
W    W     W   WdW
W    W     W   W W
W    W     W   W W
W    W  k  W   W W
W P  W  s  WM  W W
W    W     W   W W
W    W     W   W W
W    W     W   W W
W              W W
WWWWWWWWWWWWWWWWDW