WWWWWWWWWWWWWWWWWW
WssssssssssssssssW
W                W
W    T T T  P    W
WSS SSSWWWWWWWWWWW
WSS SSS          W
WSS SSS ss   K   W
WSSSSSS ss KsW   W
WSSSSSS ss WWW   W
WSSSSSS ss       W
W          WSSSSSW
WWWWWWWWWWDWWWWWWW