WWWWWWWWWWWWWWWWWW
W B   PWsssss    W
W SSSSSWsKsKd    W
W SSSSSWSSSSS    W
W SSSSSWT        W
W SSSSSWs        W
W SSSSSWSS       W
W SSSSSWkS       W
W SSSSSWSS       W
WTBTBTBS         W
WBTBTBTSsssssssssW
WWWWWWWWWWWWWWWDWW