WWWWWWWWWWWWWWWWWW
W K   TT    s   TW
WssKs Tss s    ssW
W SS  s   sW s SSW
Ws   sKs sK WsSSkW
W PSSsS   S WsKssW
Wss Ss   Kss sSSSW
W   Ks  WSS     sW
W s SSS    s  s  W
W   sss sss d   sW
WSSSSSSSSSSSDSSSSW
WWWWWWWWWWWWWWWWWW