60
WWWWWWWWWWWWWWWWWW
WsssssW BsssWTsssW
WsssssW WsssWssksW
WsssssW WsssS sssW
WWsWWWWTWsssWW s W
WW  STTTWsssW Es W
WW  WWWSWsssW  s W
WW   WWsWssTW  s W
WWdW WWWWsssWB s W
WW K WPsssssWsss W
WWWWDWssssssS    W
WWWWWWWWWWWWWWWWWW